0000000000000000
0000000000000000
4003000000000000
0000022222000000
1111111111111111
1111111111111111
